################################
#............###...............#
#...@.....#.......#.....oo.....#
#.###...ooooo.....#....###.....#
#.................#.........##.#
#..............................#
#.............#####.#######....#
#.......oo.....................#
#############.........#...M....#
#.M...................#........#
#.....###.............#........#
################################
