##########
#@.......#
#..####..#
#....M...#
##########
