################################
#.................#............#
#...@.....#.......#............#
#.###...ooooo.....#............#
#...........................##.#
#..............................#
#.............#####............#
#........oooooooooooooooo......#
########..............#...M....#
#.....................#........#
#........M............#........#
################################
