##########
#@......M#
#..####..#
#....M...#
##########
