################################
#..............................#
#...@.....#.......#.....oo.....#
#.###...ooooo.....#....###.....#
#...........................##.#
#..............................#
#.............#####............#
#........o.....................#
########..............#...M....#
#.....................#........#
#.....................#........#
################################
