##########
#@.......#
#..####..#
#........#
##########
